0000000000
0000000000
0000000000
0000110000
00011111111111111111
00011111111111111111
00001100000000000013
00000000000000000011
0000000000111111111113111110
0000000000111111111111111110
0000000000111100111111001110
0000000000111100111111001110
0000000000111111110011111110
0000000000111311110011113110
0000000000111111113311111110
0000000000111111113311111110
0000000000000000000000000000